66 IN TRODUCTION

Biograplcies

BARING-GOULD: T he T ragedy of the Caesars.

BEESLY: Catiline, Clodius, and T iberius.

BOISSIER ι Cicero and his Friends..

COLLINS: Ancient Classics for English Readers .· Cicero,

DE QUINCEY: Historical Essays and Researclzes .- Cicero.

FAUSSET: lee Student's Cicero.

FORSYTH: Life of Marcus Tullius Cicero.

FOWLER i Heroes of tlte Nations .· salius Caesar.

FROUDE: Caesar, a Sketclt.

LAWTON= Article Cicero in The World's Best Literature.

LORD: Beacon szglzts of History .· Cicero.

MERIVALE: Translation of Abeken's Lffe and Letters of Cicero.

MIDDLETON: Life of M. T ullius Cicero.

NAPOLEON III: History of Julius Caesar.

NEWMAAN: Hz’storical Sketclzes .- Marcus Tullius Cicero.

PLUTARCH: Lives of Illustrious Men .- Cicero.

STRACHAN-DAvmsont Cicero and tlte Fall of the Roman Republic.

TRoLLom-:z Life of Cicero.

TYRRELL: Introductions to Tyrrell and Purser's Correspondence of
Cicero.

Hz'stories of Roman Literature

BROWNE: Ht'story of Roman Classical Literature.
CRUTTWELL: History of Roman Literature.

DUNLOP: History of Roman Literature.

MACKAIL: Latin Lz'terature.

M IDDLETON-MILLs: Students' Companion to Latin Authors.
SIMCox: History of Latin Literature.

TEUFFEL-SCHWABE: History of Roman Literature.

M z'scellaneous

ARNOLD: Roman Provincial Administration.
BECKER: Gallus.

BOISSIER: Rome and Pompeii.

CHURCH z Roman Life in the Days of Cicero.

